11111111111111111
1000P000000000001
11000100000000011
11000000E00010011
11001110000100101
1111000C000010011
11000000000000011
11111111111111111
